###########
#0#.#.....#
#.#.......#
#.....#...#
#.....#...#
####..##..#
#.##....#.#
##......#f#
###########
