###########
#0.###.#..#
#.....#..##
#...#...###
###...#.#.#
##..##..#.#
#.#.#..#.##
#...#..##.#
####.#..###
##.###...f#
###########
