###########
#0..###.#.#
#..#....#.#
#..#.#.##.#
#..#.######
#..##.##..#
##..#.....#
##......#f#
###########
