###########
#0.#....#.#
#....#...##
##...##..f#
###########
