#########
#0#..####
#....#..#
#.#....##
#...##..#
#.##...f#
#########
