###########
#0.#.#....#
#.##.#...##
#.........#
#.....#...#
##.#.#...##
###.##..#.#
##..#..##.#
###.##...##
###...#..f#
###########
