###########
#0...##.###
#..##.....#
#...##..###
#....#..#.#
#..#.....##
#.##.....##
#..#.#...##
##.#...#.##
#.##..#..f#
###########
