###########
#0#...#...#
#..#...##.#
#...##.#..#
#.......#.#
##...#.##.#
##.#.#...##
###.#....f#
###########
