###########
#0....#.#.#
####...#..#
##....#.###
#.##..##.##
#.#..#....#
##.....####
#.........#
#......##.#
##..##.#.f#
###########
