###########
#0..#..#.##
#.........#
#.#.....#f#
###########
