###########
#0..###...#
#..##.###.#
#.#....####
#..####...#
#....#....#
##.#...#..#
#.....###f#
###########
