###########
#0..#.....#
#.#...#.###
#.###.#..##
#...###.#.#
#...##...##
#....##.#.#
#...#.....#
##.#......#
##......#f#
###########
