###########
#0##..##..#
#...#..##.#
#...#...###
#....#....#
#.#.....#.#
##..#.#.#.#
#.#..#.#.f#
###########
