###########
#0....#..##
#...#....##
#.#.#.....#
##..#...#.#
#...#.#..f#
###########
