###########
#0.#..#.#.#
#..#.#....#
##.#...#..#
#....#...##
#.#.......#
#..#....#.#
#....#.#.f#
###########
