###########
#0##..#.#.#
#..#..#####
#..#.#.##.#
#..#..##..#
#...####..#
#.........#
#.......#f#
###########
