###########
#0#.##...##
#...#....##
#..#......#
#.....#..##
####.#...##
###...#...#
#...##...f#
###########
