###########
#0###....##
#..##.....#
#......#.f#
###########
