###########
#0#..#..#.#
#.#..#..#.#
#..#......#
#...#.....#
#...#..##.#
#.#....##.#
##..##.#.f#
###########
