###########
#0.#......#
#..#..#..##
#..#.###.##
#.....#...#
#.##...#..#
##...##.#.#
##....#..f#
###########
