###########
#0..#.....#
#......#..#
#.#....#.f#
###########
