###########
#0#.#...#.#
#....#..#.#
#.........#
#.....#.#.#
#.####...##
##....#...#
#...#.##.##
###...#...#
#........f#
###########
