###########
#0.#......#
#..#...#..#
#.....#...#
#....#.##.#
#.......#f#
###########
