###########
#0.....#..#
#...##....#
#..##....f#
###########
