###########
#0...#.#..#
#.#..#..#.#
#.......#.#
#...#...#.#
#.##...#.##
##........#
#..#.###.f#
###########
