###########
#0.##.....#
#....#..#.#
#.......#f#
###########
