###########
#0.#.....##
#...#..#..#
##....#..f#
###########
