###########
#0..#.#...#
#...##..#.#
#....#..###
#.........#
#.#.....#f#
###########
