###########
#0...###..#
##..##....#
#..##..#.##
##.###.#..#
#....##...#
##.....#..#
##....#.#.#
#.##......#
#..#...#.f#
###########
