###########
#0.#####..#
#.........#
##.....#.f#
###########
