###########
#0....#..##
##..#.....#
##....##..#
#..#.##...#
#..#...#..#
#..#...#..#
#......##f#
###########
