###########
#0##...#..#
#...#.....#
#....#....#
#..#...#..#
#.....#..##
#..#......#
##....##.f#
###########
