#########
#0#....##
#.#...#.#
#...#...#
#..#....#
#.....#f#
#########
