###########
#0.###.#..#
#...###..##
#...##....#
#.....#.###
##...#....#
##..#..##.#
#.#.#..#..#
#......#.##
#.....#..f#
###########
