###########
#0#....##.#
#..#..#...#
#....#...##
#...#...###
#....#.##.#
##..###...#
#...#...###
##..#.....#
##.....##f#
###########
