###########
#0...#.#.##
##......###
###.#...#.#
###.#..#..#
##.#..#...#
##.#.#....#
#.#...#...#
#.........#
#.#.#...#f#
###########
