###########
#0##.##.#.#
#..#......#
#......#.f#
###########
