###########
#0..#.....#
#.#...#.#.#
#.#..##.#.#
##....#.###
##.#.#.#..#
#.##......#
##......#f#
###########
